##########                      ###################
#........########################................?#
#........?......................+.....#####.......#
#........##################+#####.........#.......#
##########.......#     #.....#  #.... #...#.......#
#................#     #.....#  #.....#####.......#
#................#     #.?...#  #.................#
#................#     #######  ###############.###
#####+############                            #.#
    #.#                 ############   ########+####
    #.###########       #...#?.....##  #...........#
    #.#....?#...#    ####...###.....####...........#
    #....####...#    #.......#......+..............#
    #...........#    #.......#......####.....?.....#
    #...........######.......#......#  #...........#
    #...........+...................#  #############
    #################################