##########                      ###################
#........########################................?#
#...^.............@.p...........-.....#####.......#
#.m......##################-#####.........#.......#
##########.......#     #..X..#  #.... #...#.......#
#...b....b.......#     #.....#  #.....#####.......#
#........S.......#     #.?...#  #.................#
#...h............#     #######  ###############.###
#####-############                            #.#
    #.#                 ############   ########-####
    #.###########       #...#?.....##  #...........#
    #.#....?#...#    ####...###.....####...S.......#
    #....####...#    #.......#......-......X.......#
    #...........#    #..e....#......####.....?.....#
    #...........######..e....#......#  #...........#
    #...........-.......b..m...h....#  #############
    #################################
