##########                      ###################
#@..w.h.e########################......e...e.....?#
#...^.b..?......G...h....e......-.....#####.......#
#.m.S.ppo##################-#####......S..#..m....#
##########.......#     #..G..#  #.m.. #e.?#..m....#
  #..X...X.......#     #.....#  #...G.#####..m....#
  #..............#     #.?...#  #.h...............#
  #.h..hhh.......#     #######  ###############.###
  ###-############                            #.#
    #.#                 ############   ########-####
    #.###########       #.?.#......##  #.......e...#
    #.#....?#...#    ####KK.###.....####...S...e...#
    #....####...#    #.......#......-......X...e...#
    #...........#    #..e....#......####.....?.....#
    #...hhh.....######..e....#......#  #...........#
    #...........-.......e..m...h....#  #############
    #################################