##########                      ###################
#........########################.................#
#...^.b.........................+.....#####.......#
#.m.S.ppo##################+#####.........#.......#
##########.......#     #.....#  #.m.. #e.?#.......#
  #..X...X.......#     #.....#  #.....#####.......#
  #..............#     #.....#  #.h...............#
  #.h..hhh.......#     #######  ###############.###
  ###-############                            #.#
    #.#                 ############   ########+####
    #.###########       #.?.#......##  #...........#
    #.#....?#...#    ####KK.###.....####...........#
    #....####...#    #.......#......-@.............#
    #...........#    #..e....#......####.....?.....#
    #...hhh.....######..e....#......#  #...........#
    #...........-.......e..m...h....#  #############
    #################################
